b 0 1
c 1 1
1 2 1
2 3 1
3 4 1
4 5 1
5 6 1
6 7 1
7 8 1
8 9 1
9 10 1
! 11 1 1
@ 12 1 1
# 13 1 1
$ 14 1 1
% 15 1 1
^ 16 1 1
& 17 1 1
* 18 1 1
` 19 1 1
~ 20 1 1
( 21 1 1
) 22 1 1
- 23 1 1
_ 24 1 1
+ 25 1 1
= 26 1 1
0 27 1 1
{ 28 1 1
} 29 1 1
[ 30 1 1
] 31 1 1
; 32 1 1
: 33 1 1
' 34 1 1
" 35 1 1
, 36 4 2
< 40 4 2
. 44 4 2
> 48 4 2
q 52 1
w 53 1
e 54 1
r 55 1
t 56 1
y 57 1
u 58 1
i 59 1
