--------------------
---1--1-5--5-1--1---
-----------------9--
-4----------------2-
--------------------
--------------------
--------------------
--------------------
-4----------------2-
--------------------
---3--3-7--7-3--3---
--------------------
